1 6 1169 231 1641 784 358 691 
1 10 481 1819 1294 731 2156 361 161 2006 913 358 
1 7 1281 637 1923 156 280 568 1384 
1 10 1281 1391 990 2005 1979 638 1855 1140 1362 2254 
1 7 2196 616 2206 507 1113 518 1391 
1 6 861 866 828 976 854 2196 
1 7 1169 975 2125 1114 353 1337 1715 
1 6 1715 675 554 517 1534 861 
1 14 2117 1390 1408 538 1607 1313 1658 760 1632 1379 1000 1494 1242 1169 
1 8 2111 1693 1827 902 564 89 1320 2117 
1 3 2111 608 1143 
1 6 1143 1696 1216 1554 1984 671 
1 12 2117 1218 2139 2150 1134 487 803 1745 1445 1251 929 1117 
1 2 1117 876 
1 11 876 1096 1398 2215 393 1877 1075 1247 1480 1237 386 
1 2 2254 386 
1 20 386 1421 842 853 1842 36 2262 762 169 661 2255 523 944 1625 1466 321 1961 1947 1488 546 
