3 12 8646 342 1240 7320 4080 8655 636 5991 3698 8703 8726 6064 
2 18 6064 4230 6278 848 7190 2966 7421 1225 8817 5197 4468 3987 7038 573 1974 5785 8857 7412 
3 12 8471 8470 225 3094 1842 2235 8456 3343 3288 3199 1564 6958 
2 19 6577 6236 6502 6724 1049 6316 6386 5090 6683 3526 5726 8239 532 6968 7075 5758 3467 1436 8306 
4 20 8471 3472 8461 3155 6989 8439 6558 5592 8408 7220 7170 6253 8368 8358 8360 8345 7396 4288 8317 8306 
3 19 8471 5142 7347 6748 6783 8509 263 8526 8533 7227 5061 7277 7301 4359 7121 5322 2262 8697 804 
2 4 8670 6317 8706 804 
3 9 804 784 8740 4870 3900 2193 4294 7431 6136 
3 9 8368 2516 7255 8325 8320 4342 8307 5465 8306 
3 11 1951 470 3530 2904 7446 2371 1264 8546 4787 3121 1929 
2 2 5803 7412 
3 14 8306 5362 7224 8285 6350 8277 6007 7071 8250 4839 6446 6194 8212 4797 
1 4 5511 2861 5813 8212 
2 2 8198 5813 
1 2 1842 5867 
1 6 8163 1051 8142 5483 5222 8150 
2 7 1945 5492 254 5182 8174 525 5511 
2 5 6905 8146 3541 8184 8198 
1 14 8146 6905 2570 1882 8048 24 4473 2772 7184 1085 4719 2597 4966 3251 
2 8 8057 644 1945 7367 55 5162 4331 8146 
2 9 6577 6707 3196 6054 409 6907 700 7374 8057 
2 9 7374 476 7438 4404 5650 8093 4012 6074 6905 
3 12 6958 2142 8395 8363 257 8326 2740 1329 8305 4131 7392 6316 
3 27 6958 1906 1935 270 6919 7114 8474 329 6658 984 6037 5755 738 8465 3111 3763 5556 2917 290 6692 8494 8487 208 6218 243 4277 1951 
2 8 942 386 5678 2652 6282 1158 5643 5803 
2 5 5323 6136 8760 7403 3230 
2 49 8760 1416 6563 1287 5294 2307 2993 5569 8838 3161 8862 1520 8860 3881 1822 4344 1388 3991 1046 8953 1108 5558 3464 3655 5965 8939 7444 2227 7077 4917 7126 2916 6818 5559 5721 1400 2691 4201 3540 9024 956 1966 5794 1174 5339 4974 6597 2029 6413 
3 5 3811 2792 6828 8445 6989 
3 3 8368 6679 2792 
2 9 8150 9093 4794 8206 5452 8249 3053 8232 4766 
2 2 8224 3053 
1 9 4766 8262 93 7092 3073 443 8303 6720 3938 
1 9 8262 5912 95 4930 1527 5277 5388 2969 3938 
1 63 3938 84 8351 3809 8344 8346 1617 6128 280 6161 855 4159 8407 3635 4463 851 2705 3578 188 8426 3347 593 6461 858 1268 6234 2533 3128 5901 495 889 5712 2540 5101 802 2085 2786 3803 6547 8654 1440 6285 5888 3967 3899 90 8725 1605 37 7090 1572 1161 8764 1831 4087 8790 517 8820 3870 4205 5816 785 8886 
1 2 8708 3967 
2 21 942 5789 4323 4381 4263 8712 5544 5357 3088 7197 4103 1227 8581 2675 244 8548 1273 5990 1980 5943 6218 
2 29 6707 4598 8099 3046 3411 8046 2586 5874 1098 3181 6237 2048 4361 3545 6087 867 1764 7788 4550 910 1956 3174 6484 3349 7587 1943 4918 2299 7460 
1 2 5759 1108 
1 2 2695 2227 
1 7 2193 8784 4806 1212 3014 5436 5376 
2 9 7431 1663 3217 6323 134 4067 7177 1091 5891 
2 14 1663 3247 347 8870 8890 1076 5707 1172 8966 5113 2793 5391 6185 2185 
1 11 5891 3642 496 193 1933 7364 3492 4034 1443 2530 2754 
2 46 636 4849 2618 3193 2414 970 4542 2267 1524 2896 3421 5535 2709 6526 4209 3710 7368 5866 2723 1881 6142 677 650 713 7822 7310 2400 793 7718 1026 720 7633 4613 6516 2012 3975 3735 5919 953 3618 1973 6416 3950 7486 261 7448 
2 4 6905 4171 8149 8142 
2 2 6278 5648 
1 2 6787 855 
1 8 7259 5954 5109 6637 3058 4213 6254 1929 
1 3 8695 5111 1240 
1 46 7055 2230 4409 6146 5085 2856 5519 4572 1412 7440 1166 3482 7411 2976 9083 4282 4641 6648 2957 4761 6781 203 4329 3924 952 3580 6257 4644 1144 9081 4324 1689 6987 3726 3704 1298 4857 5385 7195 6056 2131 4270 1045 9067 32 2754 
4 30 5770 1371 4523 7455 7454 7453 1392 6072 5657 4935 6518 4316 6521 6788 1529 3305 6897 5121 4041 783 7451 1664 6428 670 3885 7450 7449 5281 4913 7448 
1 4 5386 1000 5084 6484 
1 26 6566 3251 1985 2508 1462 7830 1013 5890 2271 3915 2057 2839 725 7763 7745 5766 5232 5310 1596 4717 724 7670 5455 7640 3074 6484 
1 2 2135 8860 
1 2 2435 1400 
1 3 4132 1453 2695 
1 22 7259 2092 8424 8440 507 4987 4780 6358 635 3258 4119 5583 874 4661 5604 4820 2245 1473 2438 4412 1657 2966 
1 7 6282 2046 4957 4512 7138 9028 5519 
1 5 8857 2441 153 3935 5643 
1 25 8440 484 6068 8406 3367 6932 5170 2505 4747 3684 6313 6901 3314 6865 2662 5871 5718 1404 1899 7076 721 8335 4265 2416 1524 
1 2 8512 6254 
